111111111111
1LC0E100P011
1LL0100C0C01
10C0C0100001
111111111111