111111111111
10C0E100P011
1000100C0C01
10C0C0111111
111111111111